322222222222223
300011111110003
302120202021203
311010010010113
312121212121213
301011111110103
312020202020213
301011111110103
312121212121213
311010010010113
302120202021203
300011111110003
222222222222222