020022222222223
000000000000003
000000111000000
000000000000003
300003003000003
300003002000003
300002020000003
300000000000003
300000000000003
300000000000003
301110000000003
300100000000003
222222222222022