322222222222223
300000000000003
300000111000003
300000000000003
300003003000003
300003002000003
300002020000003
300000000000003
300000000000003
300000000000003
301110000000003
300100000000003
222222222222222