322222222222223
300011111110003
302220212022203
310111121111013
312120202021213
312100111001213
321122222221123
312100111001213
312120202021213
310111121111013
302220212022203
300111111111003
222222222222222